...#....X...................................#........#.................#............#.#.......................#...............#..#
...#....X...#.....#..................................................................................#......#..#..................
........X........#.......................#.#........#......#...........................................#...#..........#...........
........X.........#..................#...#.....................................#........#.........................................
...#....X#.......#..............#.#....##.............#....##......................................#...................#..........
...#....XXXXXXXXXXXXXXXXXXXXXXXXXXXXXXXXXXXXXXXXXXXXXXXXXXXXXXXXXXXXXXXXXXXXXXXXXXXXXXXXXXXXXXXXXXXXXXXXXXXXXXXXXXXXXXXXXXXXXX#...
..#..#..XX.........#.....#...............#.......#..............................................#....#.......................X....
........XX.........XXX#..#...............#...................#....#..........................#...#............#...#....##....X....
..#.#...XX....#....X.X...XXXXXX#............#............#.#.......#................#....#..#................................X....
........XX.........X.X...X....X.............XXXXXXXXXXXXXXXXXXXXXXXXXXX#.....................................#...........#...X....
........XX.#.......X.X...X....X.............X.........................X..........#.................................#......#..X....
...#....XX...#.....X.X...X....X.............X.....................#...X..........#.............#..........#..................X....
...XXXXXXXXXXXXXXXXXXXXXXXXXXXXXXXXXXXXXXXXXXXXXXXXXXXXXXXXXXXXXXXXXXXXXXXXXXXXXXXXXXXXXXXXXXXXXX#...........................X....
...X....XX.........X.X...X....X...#.#.#...#.X.....#.............#.....X.................#..#....X..................#.#.......X....
...X....XX.........X.X.#.X....X.............X....................#....X.....#...#.....#....XXXXXXXXXXXXXXXXXXXXXXXXXXXXXXXX#.X....
...X...#XX.....#.#.X.X...X...#X.............X.......#.....#..#...#.#..X............#.......X....X................#...#....X..X....
...X....XX..##...#.X.X..#X....X...#......#..X................XXXXXXXXXXXXXXXXXXXXXXXXXXXXXXXXXXXXXXXXX#.........#.........X..X.#..
..#X....XX...XXXXXXXXXXXXXXXXXXXXXXXXXXXXXX#X.......##..#....X........X....................X....X....X..................#.X..X....
...X....XX.#.X.....X.X...X##..X...........X.X........XXXXXXXXXXXXXXXXXXXXXXXXXXXXXXXXXXXXXXXXXXXXXXXXXXXXXXX#.............X..X....
..#X....XX.XXXXXXXXXXXXXXXXXXXXXXXXXXXXXXXXXXXXXXXXXXXXXXXXXXXXXXXXXXXXXXXXXXXXXXXX#.......X....X.#..X.....X..............X..X....
...X....XX.X.X.....X.X...X....X....##.....X.X......#.X.......X........X.......#...X...#..#.X....X....X...#.X......#.......X..X....
...X#...XX.X.X...#.X.X...X....X...........X#XXXXXXXXXXXXXXXXXXXXXXXXXXXXXXXXXXXXXXX........X....X....X.....X#........#....X..X....
...X....XX.X#X...XXXXXXXXXXXXXXXXXXXXXXXXXXXXXXXXXXXXXXXXXXXXXXXXXXXXXXXXXXXXXXXXX#........X....X....X.....X..............X..X..#.
...X....XX.X#X...X.X.X.#.X....X#..........X#.#......#X.......X.....#..X......#...X.........X....X....X.....X.........#....X.#X....
..#X....XX.X.X...X.X.X...X....X...........X.......#.XXXXXXXXXXXXXXXXXXXXXXXXXXXXXXXXX#.....X....X....X.....X.......#......X..X...#
...X....XX.X.X...X.X.X...X....X...........X.........XX.......X........X..#.......X#.X......X....X..#.X....#X......#....#..X..X..#.
...X....XX.X.X...X.X.X...X....X...........X.........XX.......X........X#.....##..X..X......X....X....X.....X..............X..X..#.
...X....XX.X.X#..X.X.X...X..#.X...........X.........XX..#...#X.#......X..........X..X......X....X....X.....X........#.....X..X....
...X...#XX.X.X...X.X.X...X....X...#.......X.........XX....###X.XXXXXXXXXXXXXXXXXXXXXXXXXXXXXXXX#X....X.....X.........#..#.X..X....
...X....XX.X.X..#X.X.X...X....X...#.......X.....#...XX.....XXXXXXXXXXXXXXXXXXXXXXXXXXXXXXXXXXXXXXXXXXXXXXXXXXXXXXXXXXXX#..X..X..#.
.#.X...#XX.X.X...X.X.X..#XXXXXXXXXXXXXXXXXXXXXXXXXXXXXXXXXXXXXXXXXXXXXXXXXXXXXXXXXXXXXXXXXXXXXX#X....X.....X....#.....X...X..X....
...X....XX.X.X...X.X.X........X.#.........X.........XX...#.X.X.X..#..#X..........X..X......X..#.X....X.....X..........X...X..X....
...X....XX.X.X...X.X.X........X.XXXXXXXXXXXXXXXXXXXXXXXXXXXXXXXXXXXXXXXXXXXXXXXXXXXXXXXXXXXXXX#.X....X.....X........#.X...X..X#...
...X....XX.X.X...X#XXXXXXXXXXXX.X...#.....X.........XX.....X.X#X....#.X..........X..X#.....X.X..X....X.....X..........X...X..X....
...X..#.XX.X.X...X...X....#...#.X.........X.......#.XX.....X.X.X.....#X..........X..X......X.X..X#...X..###X..........X...X..X#...
...X....XX.X.X...X...X....XXX##.X...#.....X........#XXXXXXXXXXXXXXXXXXXXXXXXXXXXXXXXXXXXXXXXXXXXXXXXXX.....X......#...X#..X..X....
...X..#.XX.X.X...X...X...#X.X.XXXXXXXXXXXXXXXXXXXXXXXXXXXXXXXXXXXXXXXXXXXXXXXX###X..X......X.X..X....#.....X........#.X...X..X....
...X....XX.X#X..#X...X....X.X.X.X..#......X.#........X....#X.X.X......X......X...X..X....#.X.X..X..#.......X..........X...X..X#...
...X#...XX.X.X...X...X....X.X.X.X...#.....X#......#..X....XXXXXXXX#.#.X....#.X...X..X...#..X.X..X..........X..........X...X.#X....
...X...#XXXXXXXXXXXXXX....X.X.X.X.........X#.#.#.....X....XX.X.X.X..XXXXXXXXXXXXXXXXXXXXXXXXXXXXXXXXXXXXX#.X..........X...X.#X....
...X.....X.X.X...X...#....X.X#X#X.....#.#.X..........X....XX.X#X.X..X.X......X...X..X......X.X..X.......X..X..........X...X..X....
...X..#..X.X#X...X...XXXXXXXXXXXXXXXXXXXXXXXXXXXXXXXXXXXXXXXXXXXXXXXXXXXXXXXXXXXXXXXXXXXX#.X.X..X.....#.X..X..#..#....X...X..X....
...X.....X#X#X...X.#.X....X.X.X.X.........X..........X.#..XX#X#X.X..X.X....##X...X..X...X..X.X..X.......X..X..........X...X..X....
...X.....X.X.X.#.X...X....X.X.X.X.......#.X..........X.XXXXXXXXXXXXXXXXXXXX#.X...X..X..#X..X.X..X.......X..X..........X...X#.X....
.#.X.....X.X.X...X...X....X.X.X.X.........X..........X#X..XX.X.X.X..X.X...X..X...X..X...X..X.X..X.......X..X..........X...X..X#...
...X..#..X.X.X...X...X....X.X.X.X.........X.....#...#X.X..XX.X.X.X..X.X...X..X...X..X...X..X.X#.X......#X..X..........X...X..X....
...X..XXXXXXXXXXXXXXXXXXXXXXXXXXXXXXXXXXX#X.........#XXXXXXXXXXXXXXXXXXXXXXXXXXXXXXXXXXXXXXXXXXXXXXXXXXXXXXXXXXXXXXXXXXXXXXXXX....
...X..X..X.X.X...X.#.X....X.X.X.X.......X.X............X.#XX.X.X.X..X.X...X..X.#.X#.X...X..X.X.#X...#...X..X..........X...X..##...
...X..X..X.X.X...X...X....X.X.X.X#......X.X#...........X.#XX.X.X.X..X.X...X..X...X..X..#X..X.X.XXXXXXXXXXXXXXXXXXXX#..X#..X.......
..#XXXXXXXXXXXXXXXXXXXXXXXXXXXXXXXXXXXXXX.X............X..XX.X.X.X.#X.X..#X..X#..X..X...X..X.X.XX.......X..X....#.X...X...X.......
......X.#X.X.X...X...X...#X.X.X.X.....#.#.X............X..XX.X.X.X..X.X...X..X...X.#X...X..X.X.XX.......X..X......X...X...X.......
..#...X..X.X.X##.X...X....X.X.X.X....#..#.X............X..XX.X.X.X.#X.X#..X#.X..#X..X...X..X.X.XX.......X..X......X...X...X.......
......X..X.X.X...X...X....X.X.X.X.......XXXXXXXXXXXXXXXXXXXXXXXXXXXXXXXXXXXXXXXX#X..X...X..X.X.XX.......X..X......X...X...X.......
......X..X.X#X...X...X..#.X.X.X.X.#....#X.X............X..XX.X.X.X..X.X...X..X.X.X..X...X..X.X.XX.......X..X.....#X...X...X.......
......X..X.X.X...X...X....X.X#X.X.XXXXXXXXXXXXXXXXXXXXXXXXXXXXXXXXXXXXXXX#X..X.X.X..X...X##XXXXXXXXXXXXXXXXX......X...X...X...#...
......X..X.X.X...X...X#...X.X.X.X.X..#..X#X............X..XX.X.X.X#.X.X.X.X..X.X.X..X...X....X.XX.......X..#......X...X...X.......
......X..X.X#X...X...X....X#X.X#X.X..#..X.X#..........#X..XX.X.X.X..X.X.X.X..X.X.X#.X...X..#.X.XX.......X..#......X...X...X.......
......X..X.X.X...X#..X....X.X.X.X.X.....X.X....#....#..X..XX.X.X.X..X.X.X.X..X.X.X..X...X..XXXXXXXXXXXXXXXXXXXXXXXXXX#X...X.......
..#...X..X.X.X...X...X....X#X.X.X.X.....X.X............X.#XX.X.X#X..X.X.X.X..X.X#X..X#..X..X.X.XX#......X.........X.X.X...X.......
......X..X.X.X...X...X....X.X.X.X.X.....X.X......#.....X..XX.X.X.X..X.X.X.X..X.X.X..X...X..X.X.XX.#.....X.........X.X#X...X...#...
.#....X.#XXXXXXXXXXXXXXXXXXXXXXXXXXXXXXXXXX............X..XX.X.X.X#.X.X.X.X..X#X.X#.X...X..X.X.XX.......X.#.......X.X.X...X.......
......X....X.X...X...X....X.X.X.X.X.....X.#.......##...X..XX#XXXXXXXXXXXXXXXXXXXXXXXXXXXXXXXXXXXX.......X....#..##X.X.X...X...##..
......X....X.X#..X#..X....X.X.X.X.X.....X..........XXXXXXXXXXXXXXXXXXXXXXXXXXXXXXXXXXXX#X..X.X.X#.......X.........X.X.X...X.#.....
......X....X.X..#XXXXXXXXXXXXXXXXXXXXXXXXXXXXXXXXXXXXXXXXXXXXXXXXXXXXXXXXXX..X.X.X..X#X.X..X.X.X........X.........X.X.X...X...###.
....#.X....X.X..XXXXXXXXXXXXXXXXXXXXXXXXXXXXXXXXX#.X...X..XX...X.X..X.X.X.#..X.X.X..X.X.X..X#X.X.....#..X..#...#..X.X#X#..X.#.....
...##.X....X.X.#XXXXXXXXXXXXXXXXXXXXXXXXXXXXXXXXXXXXXXXXXXXXXXXXXXXXXXXXXXXXXXXXXXXXX.X.X..X.X.X........X.........X.X.X...X.......
#....#X....X.X.#.....X....X.X.X.X.X.#.#.X.......X..X...X..XX...X#X..X.X.X..##X.X.X..#.X.X#.X#X.X........X........#X.X.X...X.......
......X.#..X.X....#..X....X.X#X.X.X.....X......#X..X...X..XX...X.X#.X.X.X..XXXXXXXXXXXXXXXXXXXXXXXX#....X..#......X.X.X...X.#...#.
.#....X....X.X.......X....X.X.X.X.X.....X...#..#X.#X...X.#XXXXXXXXXXXXXXXXXXXXXXXXXXXXXXX.#X#X#X.#X.....X.........X.X.X...X.......
....#.X....X#X.......X#...X.X.X.X.X.....X......XXXXXXXXXXXXXXXXXXXXXXXXXXXXXXXXXXXX#..X.#..X.X.X..X.....X.........X.X.X...X.......
......X....X.X.......X....X.X.X.X.X.....X......XX..X...X...X...X.X..X#X.X#.X.X.X.XX...X....X.X.X#.X.....X.........X.X.X...X.......
......X....X#X....#..X..#.X.X.X.X.X#....X......XX..X...X...X...X.X..X.X.X..X.X.X.XX...X....X.X.X..X.....X.........X#X.X...X.......
......X....X.X.......X...#X.X#X#X.X....#XXXXXXXXXXXXXXXXXXXXXXXXXXXXXXXXXXXXXXXXXXXXXXXXXXXXXXXXXXXXXXXXX...#.....X.X.X...X...#...
......X....X.X.......X....X.X.X.X.X............XX..X..#X#..X...X.X..X.X.X..X.X.X.XX#..X#...X.X.X..X.....#.........X.X.X...X.......
.....#X....X.X.#.....X...#XXXXXXXXXXXXXXXXXXXXXXXXXXXXXXXXXXXXXXXXXXXXX.X..X.X.X.XX...X.#..X.X.X..X.........#.#...X.X#X...X.......
......X....X.X.XXXXXXXXXXXXXXXXXXXXXXXX#......#XX..X...X...X...X.X..X.#.X..X.X.X.XX...X....X.X.X..X...............X.X.X.#.X...#...
.....#X...#XXXXXXXXXXXXXXXXXXXXXXXXXXXXXXXXXXXXXXXXXXXXXXXXXXXXXXXXXXXXXXXXXXXXXXXXXXXXXXXXXXXXXXXXXXXXXXXXXXXXXXXX.X.X...X.......
#.....X....#.X.X#....X......X.X.X.X...X........XX..X.#.X...X...X.X.#X...X..X.X.X.XX#..X....X.X.X..X....#..........#.X.X...X.......
..#...X......X.X.....X......X.X.X.X...X##......XX..X...X...X...X.X..X...X..X.X#X.XX...X....X.X.X..X...........#.....X.X...X.......
....#.X......X.X.....X......X.X.X.X...X#.......XX..X...X...X...X#X..X...X..X.X.X.XX...X....X.X.X..X.................X.X...X.......
....#.X......X.X.....X......X.X.X.X...XXXXXXXXXXXXXXXXXXXXXXXXXXXXXXXXXXXXXXXXXXXXXXXXXXXXXXXXXXXXXXX#..............X.X..#X.......
....#.X......X.X.....X......X.X.X.X...XX.......XX..X...X...X...X.X..X...X..X.X.X.XX..#X....X.X.X..X.X...............X.X...X.......
......X...#..X.X#....X......X.X.X.X.#.XX.......XX..X...X...X#..X.X.#X...X..X.X.X.XX...X....X.X.X..X.X...............X.X...X.......
#.....X......X.X....#X......X.X#XXXXXXXXXXXXXXXXXXXXXXXXXXXXXXXXXXXXXXXXXXXXXX.X.XX...X....X#X.X..X.X....#..........X.X.#.X.......
...#..X#....#XXXXXXXXXXXXXXXXXXXXXXXXXXX.....#.XX..X...X...X...X.X..X...X.#X##.X.XX...X....X.X.X..X.X..............#X.X...X.......
......X...#....X....#X....#.X.X...X...#X.......XX..X...X...X...X.X.#X...X..X...X.XX#.#X...#X.X.X..X.X......#.......XXXXXXXXXXXXX##
.....#X...XXXXXXXXXXXXXXXXXXXXXXXXXXXXXXXXXXXXXXXXXXXXXXX#.X...X.X..X...X..X...X.XX...X....X.X.X..X.X..............XX.X...X....X..
......X...X.##.X.....X......X.X...X....X.......XX.#X...XX..X...X.X..X#.#X.#XXXXXXXXXXXXXXXXXXX.X#.X.X.....#....##..XX.X#..X#...X..
......X...X#...X...#.X......X.X...X....X#......XX..X...XX..X...X#X.#X...X......X.XX..#X....X.#.X..X.X..#...........XX.X...X....X..
#.....X...X....X.....X#..#..X.X...X....X.......XX..X...XX..X...X.X..X...X......X.XX...X....X...X..X.X..............XX.X.#.X....X..
....#.X..#X....X.....X..#XXXXXXXXXXXX##XXXXXXXXXXXXXXXXXXXXXXXXXXXXXXXXXXXXXXXXX.XX...X....X...X..X.X........#.....XX.X...X.#..X..
......X..#XXXXXXXXXXXXXXXXXXX.X...X.X..........XX..X...XX..X...X#X..X...X......#.XX...X.....#..X#.X.X..#....#......XX.X...X....X..
......X##......X.....X...X..#.X...X.X...#......XX.#XXXXXXXXXXXXXXX..X...X........XX...X...#....X..X.X..............XX#X...X....X..
.#....X...#.#..X.....X...X....X...X.X#.........XX#.....XX..X..#X.#..X...X.#......XX#..X........X.#X.X..............XX.X...X....X..
......X........X..##.X...X..##X...X.X..........XX......XX..X...X....X...X.XXXXXXXXXXXXXXXXXXXXXXXXXXXXXXXXXXXXX#...XX.X...X....X#.
...#..X........X.....X.#.X...#X...X.X....#.....XX..#..#XX..X...X...#XXXXXXXXXXXXXXXXXXXXXXXXXXXXXXX.X.#.....#.X....XX.X...X....X..
......X........X.#...X...X.#..X...X.X.#........XX..#...XX.#XXXXXXXXXXXXXXXXXXXXXXXX.#.X........X..#.X.....#...X....XX.X...X....X.#
......X........X.....X...X....X...X.X.XXXXXXXXXXXXXXXXXXXXXXXXXXX#......X.X......#X...X#.#....#XXXXXXXXXXXXXXXXXXXXXXXX...X....X..
......X........X.....X...X#...X...X.X.X........XX......XX......XX.......X.X.......X...X.............X.........X....XX.#..#X....X..
......X.......#X.....X...X....X...X.X.X........XX......XX......XX.......X.X.......X...X.........##..X.........X....XX...#.X....X..
....#.X.#......X.....X...X...#XXXXXXXXXXXXXXXXXXXXXXXXXXXXXXXXXXXXXXXXXXX.X..#....X...X.......#.....X......#..X....XX.....X....X..
......X........X.....X...X........X.X.X........XX......XX......XX.......#.X......#X...X.............X.........X....XX.....X....X..
....#.X...#....X.....X...X.......#X.X.X..#.....XX.....#XX......XX.........X.......X...X......#......X.........X....XX.....X....X#.
......X........X#....X...X........X.X.X........XX#.#...XX......XX#.#......X..#....X...X......XXXXXXXXXXXXXXXXXXXXXXXXXXXXXXX#..X..
......X.......#X.....X...X.......#X.X#X........XXXXXXXXXXXXXXXXXXXXXXXXXXXXXXXXXXXXXXXXXXXXXXXXXXXXXXXXXXXXXXXXXX#.XX.....XX...X..
...#..X.......#XXXXXXXXXXXXXXXXXXXXXXXXXXXXXXXXXXXXXXXXXX......XX..#......X.......X...X......X.....#X.........X#X..XX..#..XX...X..
......X..............X...X........X#X.X........XXX.....X#..#.#.XX.....#..#XXXXXXXXXXXXX......X...#..X#.....#..X.X..XX.....XX...X..
......X#.....#.#.....X.#.X..#.....X.X.X..#.....XXX.....X.#.....XX...#.............X...#......X.#.#..X.........X.X..XX.....XX...X..
.....#X...#.........#X...X...#....X.X#XXXXXXXXXXXXXXXXXXXXXXXXXXXXXXXXXXXXXXXXXXXXXXXXXXXXXXXXXXXXXXXXXXXXXXXXXXXXXXXXXXXXXX...X..
..#...X....#......#..X...X........X.X..........XXX.....X.......XX..............#..X.......#..X......X.........X.X..XX.....#X...X..
..#..#XXXXXXXXXXXXXXXXXXXXXXXXXXXXXXX....#.....XXX.....X......#XX.#.#.............X..#.......X......X.......#.X.X..XX......X...X..
.....................X...X........X.#......#...XXX.....X.......XX#...........#....X..........X.....#X.......#.X.X..XX......X...X..
.#..................#XXXXXXXXXXXXXXXXXXXXXXXXXXXXX.....X.......XX.................X..........X......X.........X.X..XX......X..#X..
..............#..........X#.#....#X.#......#..#X#X..#.#XXXXXXXXXXXXXXXXXXXXXXXXXXXXXXXXXXXXXXXXXXXXXX.........X.X..XX......X...X#.
...#............##.......X........X.XXXXXXXXXXXXXXXXXXXXXXXXXXXXXXXXXXXXX#........X..........X...#..#.........X.X..XX......X...X..
......#........#.........X#..#.#..X.X...#......X.X............#XXXXXXXXXXXXXXXXXXXXXXXXXXXXXXXXXXXXXXXXXXXXXXXXXXXXXXXXXXXXXXXXX..
...#...........#.........X........X.X..........X.X.......#......X.....#.X.........X.#....#...X................X.X..XX......X...#..
...........#.............X.......#XXXXXXXXXXXXXXXXXXXXXXXXXXXXXXXXXXXXXXXXXXXXXXXXXXXXXXXXXXXXXXXXXXXXXXXXXXXXXXXXXXX...#..X......
.......#..............#..X..........X.#........X.X.#............X.......X.....#...X..........X.............#..X.X..X##.....X......
.............#..........#XXXXXXXXXXXXXXXXXXXXXXXXXXXXXXXXXXXXXXXX......#X.........X.....#....X................X.X..X...#...X......
...............#....................X.........#X.X..............#.....#.X.........X....#....#XXXXXXXXXXXXXXXXXXXX..X.......X......
............#.................#.....X....#.....X.X#............#..#.....X#........X..............#....#...#.#.X.#.#XXXXXXXXX......
.......#.#..........................X........##X.X...........#.....#....X.........X......#....................X............##.....
..#..#...#...#....#.............#..#XXXXXXXXXXXXXXXXXXXXXXXXXXXXXXXXXXXXXXXXXXXXXXXXXXXXXXXXXXXXXXXXXXXXXXXXXXX..........#........
......#......................#...#...#.........X#XXXXXXXXXXXXXXXXXXXXXXXXXXXXXXXXXX....#.................#....#.................#.
.......#...........#...........#...............X...#....................X.........#.......................................#.......
......#.......................................#XXXXXXXXXXXXXXXXXXXXXXXXXX.....................#.........#........#....#.........##
......#.................................................................#...#............#..........#.............................
.....................................#..........#.........#.....#.............#...........#.......................................
.#.....................................#......................#.....#..#..........................................................